..................
.==.===========.==
.= . =....=====..=
.= ....=.........=
.=================
.=   = 
...=   ===========
.===== 
.   ==============
.==             ==
.=               =
.
.=================
.==.. = ==  ==  =
....=      ==  == 
.=== ==    =
.. =    =  =   = =
.. =    =  = === =
.......==      =
