
 == =========== ==
 =   =    =====  =
 =     =         =
 =================
 =   = 
   =   ===========
 ===== 
    ==============
 ==             ==
 =               =

 =================
 ==   = ==  ==  =
    =      ==  == 
 === ==    =
   =    =  =   = =
   =    =  = === =
        =      =
